rbsB	atgacgtatttatgtcaccatcaggtcatacaacctgattaaaaTtactgcttaacaaccagtttcagatcaaccggatacttagcctga
rbsR	gaaaacaaccgatggtaataatttgatcaaaagacagcgtaaatTtaagccgaaccgcgttccatcagaatcggagtaagttgtaatcgt
ilvL	cggacctttcggtgcgggggtcttagttcgttaaggcttgatctTtaagcctttcctcgtccaagtgcagccccgcacggtgggataata
ilvA	cacaaatgacgttgtcgcgcgggtaggcctgataagcgaagcgctatcaggcatttttccTtaacccgccaaaaagaacctgaacgccgg
wzzE	ctttcacatcgattctcttcgaataagcggcgagcgcctttgcgctcaccgcagcagtgttgTtatttcgagcaacggcgggttaatgcg
aslB	ggcgtttacgccgcatccggcaatcaaccgcaggcggccgccgatttTtacttactcaccaccagcaaatgcgcatgcataatgtcgctg
hemY	agctgcagctatgcgtcgcgacggtttgatgttaacgttgcagaataacccgccacagtaAttccttctcacccggaggcaagcacctcc
yigG	ttcagtatgctaatgcttgcacctactgattcatcaaaacaataAttatggagtatttatgagtaaggaatatatgaacgatggttcatt
recQ	aacgtttacggagtcttcatactggcacttttttatgctgctgaTtactcttcgtcatcgccatcaacatgcgcacgaatcagcgccata
rmuC	gtcgatgccctagatttctacccggcttaactactcccaatgggTtagcgcgactgctgattatattcatcatcgcgttgataagcttca
tatD	aaagagattaagcacagtgtgaagaataccgagttccgcaaactTtaaaacgcaatcccaaacagtgttttgacattagcatccgtggtg
yihL	gttgtagaatctttcttgcgttatttattgtcaccataaaacacTtacagattaatgatgaggtctacggcctcaaatcgccaatattca
yihW	ggctatgtggcaaggtatgaagccaggttaacggtcacaaaaatTtacgcgtcttcctggggaagaatgatttcaatttggctgtcttgt
yiiD	ccaaggactaatataaatgacctgaatgagagaggcagcaccgcccctctccatcagTtactcttcttcgttcccgccctcttcatacgg
cpxP	ggggaagacagggatggtgtctatggcaaggaaaacagggtttaTtactgggaacgtgagttgctactactcaatagcttcaacgatgaa
frwD	ggaatatcgccggcagtaccacagccaactgacagaaaaaccgaTtactccagaataagatgggtttgctgcggcgcagaaagcactttg
zraR	tatccactgggacgactgcttctgccggaaagatatcggctggcgcgctatcgaacgcgagcagaaTtaacgcgacagttttgccaatag
yjaB	gggaaaccgtatccgttgctgaatctggcgtatgtgggggcgtaAgcgattttttctcatcccggtgggctgaacttcaggtttagtacc
yjdK	ttagagaatagtgccattttttatgttcttcttatccttcctggTtacttgtaaaactgacggaaatagtcatcaactgtcataatgttg
blc	tttgatgtcagtaaatttatttgggtacagcagcctggtagttaAtgagtgctgagtttcagaccaataatccccaatacgattaacgcc
ulaF	agaccagttatctcccgaggaaggaaatttccgcagcgcgtgttTtacttctgcccgtaataagcgttaggaccgtgtttacgcatgaag
yjfY	gggagtaacggcaatatgcacgccagcgcggatatttatcgctaAcaccaggtataaccaacgaaacattgccatagtttgctttgcccc
priB	tgaaacggcagaacttgcgacgacggaaataacgtgccatatggTtagtctccagaatctatcaattcaatctgctcggcatgcaaaacc
ytfB	ctgttcacccgccagccggatggcagttttattcgtgcgcggtaAatgaagggtcaaccaaaagccagctaaggattgtctctttgatga
ytfG	acgttagccgaaagcgtaagccatctttttaatgttaataactaAttaattaaagtggcatcctcccgcatcctctctgataatgacggg
msrA	ttactgtggaattggcggaattggcgtctgtctgccgccggaagcataAcgttacgggtacaaatgtagtttgttgataaagtgctcttt
ytfN	gccttgtttgtggcgtaaactgccgtagacaaatattcgcattgTtaaaactcgaactgatagagcaaatccagtgcctggtctacacca
b4250	atatctgcgcgccgcttcttttaatacctcaaccaggcactcgcTtaccggacgatcatcacgaagaatatcggcaagcggaatagcttc
idnR	actgttgacctcgggtatcagatttatcacggcaacacgctttaAgttattttctcttcattacacgtattctctttgccggacgttgcc
b4273	gtataaaatatccgtattcatatcagcacaaggtggatttgcccTtatatttccagacatctgttatcacttaacccattacaagcccgc
yjgX	atgatgggttctcatccaaatccgtgtgacagccttaactcctaAccgaataattacctggagcagtatccccgaaaaattgcctgttac
b4283	ccgaaagagataattgaaaggggtgttgcattgacagattgaatTtacagtagcctttttaatatttcattctccatttcaatccgttgt
fecE	caccccgagccggtatctggcaggccgatgtgcctaatgaggtaAattgcacaggccgtaagaaccaaaccacgactgaatgaaactgga
nanC	ttatcggaaaacagttatcgcattggtgtgtcatttaaactgtaAtagacaggagacagtcacaatgaataaaacaataacggcgcttgc
fimB	taagaataatgtagtttttaacaccatccctggtatctcaactatctTtataaaacagcgtgacgctgtcgtcctctggctctatcccag
yjiN	ttgctgtcgcagctcccggccttgttccccctcggcaatttttaAaaatccatgaaaaactaagtggctaaccgcgagagagatcaaata
yjiP	ccgtgataaaatagcatcgggatgaccaacggtagcggctggcgtttatcatgctctatatggcgTtacatcaccgccatggaatagcgc
mcrB	tataaacaacagaaatggaccaacaaattattaggggactcataAtggaacagcccgtgatacctgtccgtaatatctattacatgctta
yjjQ	tctgaataaactctcaataccgatactactcatgacgcatttttTtatgagtgcgacatttctcttcttaattcggctgtgttccattct
yjjV	gcattgtgcgccaactgccggatgcggcgtgaacgccttatccggcTtacggcacgttaaacaacgtatacgtgttattaagcaacgctt
lplA	aggaaaaagagctacgggagttatcggcatggatggcgggggctgtaaggtaAttacccgcccatgcgggcaactttctcttcgatttgc
creC	gcaatggcagcaggatacgaagactatgtgggaagaatttgaagTtatgtgaagtgacggtgaagtcgaagcgaggccagcacgccacct
kefF	atgggtacaatcagcgctgccgaaccgagataaatcagcgcctgaatcagcgtatggTtatccatgatgggcctcctgccattccagcag
yabI	gacgcggcaagcgtcgcatcaggcaacccgcacaagactatctcTtaaaccccaaccactttacgcaaaatatcgatatacaccggcatc
thiQ	tgaccaatgagttgttgagcggtaaggcgagtgcttcggcactattggggattacgggttaAtatgcactgtcggatgcggcgtgaacgc
murF	gttaaagccggaataatatttgaccaaatgttcggccagccaaaTtaacatgtcccattctcctgtaaagcgcgtactacctcttccatg
mutT	catcaggcatcgtgtgcgaatgtcggatgcggcgaaaacgccttatctgacTtacagacgtttaagcttcgcaattaccggttcattggc
pdhR	cgcttgatttacaacatcttctggataatttttaccagaaaaatcaTtaattctttcgttgctccagacgacgcagagaacgctcacggc
sfsA	gctgaaggcatggctcttaaaaaatcactgccggttacattgtaAtaaagtaagtaactggttaatttacattctggtcgcgtgcgcaaa
btuF	tatcctcgctgcacaacagctctgtaatgcgctttcacaggtagattaAcgcctgaccttttcaggtgctcagtggggattgaacaatgc
cdaR	gctgaggggaatgagccagcgccgcctcaaccttaacgcataacTtaccgctcttcatccagttgtaacgccacatacagcagcaacctg
yaeI	cgtctgaactgccgcccggaagtaacgatgctggaactggtgtaAatcgtgaattttatcaccagaataaagcaggtaattttttgattt
yafL	acctgcgtacaactgccggatgcggcgtaaacgccttatccgtcTtacaaaatcgtctcttccgtcaaaatcctgcgcgcgcccaaaaaa
yagY	cgggttgcactttggcagggtgataagttcattcccgtgaaataAatagctgtgcagatggataacgacaatgcctttacgacggttctc
eaeH	catgtgagtcacctctgactgagagtttactcacttagccgcgtgtccaTtattgctgggtaagaggcactggcgtataggtcacctcgg
b0299	acccgaggactttatgatcctacccacgtaatatggacacaggcTtaagcgaggttcttgttttcaaattgttccggactgaggccgcca
yahL	actctcaggtggaataacaacttgcaggtggaaccctttctgaaTtaaagagtgtagcggattttaacgtgcttatttacaggataatat
yahM	gatttacgaaggggtgacgcagcggtgagcagataatttactctTtacgtaatcaacctgatttgccgaatcacggccatcggcgatgat
prpE	catcggcacacagtgccggatgcaccgcgcgacgcatccgacaataacTtactcttccatcgcctggcggatctgatccaacgacgcagg
cynR	tggcgttggataaatgcgcggttgttggcggaaatgaatcacggtaAccgctgacacaggtctgcggctggaattgcctgatgcgctacg
frmR	tccgttgacgacactattgaactggttcgtgcctatcttaaataActgaatctattaccatattgaggaagagcgagagatgaaatcacg
b0361	gtagtgattggcgcaaactgcctgataggtaattggatttgcccTtatatttccagacatctgttatcacttaacccattacaagcccgc
yaiS	tatttcacagtcaaacttgctgcattaaaaaaacataaaagctaAgaacgacgcgattatatgcgtcatgatcgcctgcgtgcagttgca
tra5_1	ggcggcctcagtccggaacaatttgaaaacaagaacctcgcttaAgcctgtgtccatattacgtgggtaggatcaatcagccccccaccc
araJ	gtcgctataagcgccagcaagcggcggatactccggtgctggcgaaaccactggggtaAgttatagtctcggtgctcattacttattgcc
pgpA	gtcgtaggatttaaataagagtccaggcctgatgagacgtgacaagcgtcacatcaggcatcggtgcacaaTtacgacagaatacccagc
yajL	ggcgtgaaaaagcccatgaagtggcatcacaactggtgatggcggcagggatttataattattacgagtaAtgtcggatgcggcaaacgt
panE	agtgaatatgagcgcatcggcactggtttgcctcgcccctggtaAtgaagagactgaagccgtcaccactatcgatctgctggttcgcgg
lon	agcctgccagccctgtttttattagtgcattttgcgcgaggtcaTtattttgcagtcacaacctgcataccagacggttcattttgcagc
mdlA	ggcgaaccgtacgctaacaggcgcttgagagtcggccacagttggctaaaaTtacgcatcgacggcctcctcgcgattttccggagcgtc
ybaA	tttcttacgctgggccgagcaacatttgtgaatttttgggctgacggcacgccgcacagcccgtcacgctacTtattcgtcgatgattga
ybaJ	tttgtcaatgcgacgaaagagaatcctgcgagtttatcttgttaAaattattacaaccataggtagaagtatgtccgaaaaacctttaac
priC	gcgctggaaaaaatcgaaaacaggttagcgcgtttaacccgctaAcaatggagagaatatgtcactggaaaatgcccctgacgatgtcaa
aes	gaggctcttcgcgacggcgctcagttctttaccgctcagctttaAcgatacgcggcaacaagattagccatcatttcgatatgttccggc
ybcF	acgcgtcaagcgtcgcatcaggcacaaatgtctaatgcctacgaTtacagcgaaatacaggtccccgcttcgcccgccagcgtctcttca
tra5_2	tgatttatgctggttgatcctacccacgtaatatggacacaggcTtaagcgaggttcttgttttcaaattgttccggactgaggccgcca
ybcL	tcgatctttaagttagtcttacctcttgccagcatactctcaccTtactttatctcataaactggtgttatctcagcggttgcgatttta
rzpD	ttgctcaaaataattgcatgagttgcccatcgatatggtcagctTtatctgcactgctcattaatatacttctgggttccttccagttgt
ybcY	aaaaccaaggttcaaggtactgtagtaatgttttccgcttcaggaaaaaaataAcatccaaccgcagcatgttcttgcttaagacgtgct
hokE	taaatcatatcaggcgtaataccacaacccttaagttagcgcttatgggattactccccgcacaacggTtacttcttcggttcgtaagcg
ybdL	ctgaagcaaattaacggcctgcaagagttgtttgccgaccgtcaatattcccgcgcctggacggttaaatagTtaaagctggcgcaggcg
ybdM	tgaagcaaattaacggcctgcaagagttgtttgccgaccgtcaatattcccgcgcctggacggttaaataActaaagctggcgcaggcgt
rlpA	caaaccgaagcccaattacagtcatttattactaccgcgcagtaAcgtaaagcaggcatctgatgtgtcaatttctgtaaatgacgttaa
ybeQ	catccggaaccagagatgtcagtcaggaaattcgtgagactgaagatttactgtaAagataaaaacaagggccggggaatttcattcggc
ubiF	cgtcttatccgacctacggttggcacgcatccggcaatgttgtaaggTtacaaccctaacgcatatttcagcgcctgacgtttcaacacg
ybfH	caccgatgggtgcgcttgtctatggctccggaggtctgctgattgataatggttaAttacgcatagcaggatctggtcacccccggttgc
ybfD	cgcaaggactgacgtcaggtagtttctaaccatagctgccctttTtattcaaacgtgaaatcaataagctcatcagggacatcgcaaaca
nei	tgccattgcgcggtttatttcaacctatgcgccgaagcggtcggcTtagtgctggcagccagggcaccagtaaaacgggcgagatgacag
abrB	tgacagggcctgccattgcgcggtttatttcaacctatgcgccgaagcggtcggcctaAtgctggcagccagggcaccagtaaaacgggc
sucB	gataatgccttatccggtctacagtgcaggtgaaacttaaactaTtacacgtccagcagcagacgcgtcggatcttccagcaactctttg
bioD	tcgaagacgcgatctcgctcgcaatttaaccaaatacagaatggTtacaacaaggcaaggtttatgtactttccggttgccgcattttct
moaE	cgtaaacgtatgtactgagcggtgaaattgccggacgcagcggtgccttatccggctaacaaaaaaTtaccagcgttttgccgcctgctg
ybhM	gcgatgtgaagtttagttaagttctttagtatgtgcatttacggTtaatgaaaaaaacgcgtatgcctttgccagacaagcgttatagct
ybhS	tttatcggcctgacgtggctgaaaaccaaacgtcggctggattaAggagaagagcatgtttcatcgcttatggacgttaatccgcaaaga
ybiH	catatcgacctgattttgcaaggattatcgcaaaggagtttgtaAtgatgaaaaaacctgtcgtgatcggattggcggtagtggtacttg
ybiR	tctgaattaatcttcaaaacttaaagcaaaaggcggactcataatccgccttttttatttgccagaccTtagttggccgggagtataact
yliD	tttcctgtgaggtgattaccctttcaagcaatattcaaacgtaaTtatcctttaattttcggatccagcgcatcgcgtaaaccatcgccc
yliE	gactgactgtaagtacgaacttattgattctggacatacgtaaaTtactcttttactaattttccacttttatcccaggcggagaatggc
ybjK	tcggttcaaggttgatgggttttttgttatctaaaacttatctaTtaccctgcaaccctctcaaccatcctcaaaatctcctcgcgcgat
rimK	cgcaaaaagcgcaggcaaaaccatgatcagtaatgtgattgcgaTtaaccacccgttttcaggcaatattctgtcgtagcgtggcgttcg
ybjR	atcgagaaaactgccgcctggctacgcgaccacggaaaactgccgcgTtaatcctgcccgtatttctccagcaatgcttcggcaatcgcc
cspD	gccagtgttattgtgcccgtcgaagtagaagcggcagtcgcataActcttctgtctcattgtgtacatcctaaaggcaaaatgccagccc
lolA	aaagtattatccgaaaaatcgagcgacagattgctcactcaggtgcctTtacttacgttgatcatctaccgtgacgccttgcggcggggt
ycaI	ttatgcattcaaaaaaccagcatttgttgaaatagccgcatattTtacccgttatccactggcacgccaaaccactgatgataccaacga
lpxK	agcgacattcatgactccatcaatcgaacgctgccgcggcgtaaTtagttgccagaagccagcaaggttagttgcgtaagcagtttcgct
ycbK	aataatacgatagttcatactgcccctgtttcgttaagcaattaTtaccagtgccgtgctggcccggtatcaatatgcacaaagttacta
ycbX	tgctgtagctgtgtaccgaagactgcacttaagttggcgcgttaAactgcctgttcgaggctgaagctgtcaacattaacctgcggtttc
tra5_3	ggcggcctcagtccggaacaatttgaaaacaagaacctcgcttaAgcctgtgtccatattacgtgggtaggatcaaaatgccgctttatg
yceO	ggattgttggcaattatggatctgatctatgtgttttatttttaAttttccgcactgacataaactgacaaatatttaatctccctttca
yceF	gctaatcgcgctgtgtcagatgttacgtcgggaagggaaaaacccgctgatgggataAttttttgcgccggatgtggttacgtcgcatcc
plsX	atataccgtcacttgcaaactgcgagttcgctggcagcgtcctgTtaccgcagagttccgcttttgccaccgtccagcagctcaaaacca
fabH	ccagggaacacaaatgcaaattgcgtcatgttttaatccttatcTtagaaacgaaccagcgcggagccccaggtgaatccaccgccaaag
pabC	taccaccagcaataacaagattatcaataacacttttttcatgaTtaattcgggcgctcacaaagtggggctaaatattcatataacgtt
b1146	cgattagcctcatcgttctgtggttaaaaattgaaagtgttctgTtaatctttcggatagatatccggtcttaagtcagatttcgtaatt
ymfM	ccatcccatacatagccggttaatttagtgctcatgaccgacctTtatttccctgaatttacgacgaaactgttcgagcgggctgaagca
ymfR	tcaccggtgcgtcactttttcgttgaaataatcccgaaaagaacaTtatttacctccgccgacagacgactgtgtacggtcgagatatcg
tfaE	cagataccagcaccgcgccggatgtcatctggcctgaactgccggaggcgtaAgccattcaatatctggcgcactggatgtatcaaccag
ycgX	cttttatatattgaagatgtagaaaataataaaccattaatctaActaaagttggatacttaagaaatgcttcataattcagtaaggcat
ymgC	catggtgatacagctgatgtttattctaaaaccttactcaagttTtaagagagcacggattccctgtcattaataatgatatccgttagt
ycgY	ttctccggatggcgttgtcggcagataacaccatagctatggttttttTtacacagacggtttttcaagtcctggcgggaagtattgcgc
hemA	cataggcgtaaatgcaccctgtaaaaaaagaaaatgatgtactgTtactccagcccgaggctgtcgcgcagaatattcaggcgttcgtta
b1228	aaaagtccctgaactctcaagcgaatccgcaatcaaatattctgcccatgcggggaaggatgagaagcttcgaTtaaggttcggctcgag
kch	gaactagaaacgaaagctgacagtaaagaatcggcgcaaaaataAagtttaaagacggaagagtaaacttattgggcaccgcaatggtgc
sapB	ctgatattttgggtgccatggctaaccctctgaaacataaggaatggtatgccttacgataAcgtatacagcgaaaagcgcccgccgggc
pspF	acttatcatcagttccgcgcgttgttgaaaaagcaccagatttaAcgaagttgagcaatacaacttgccggatgcggcgtgaatgcttta
ycjU	tttgaatatgttgtaacgaaagctgagccatgttgattcctttgTtatacgttttgccagaaggccgataaccgcggccaggtgagtgat
ycjV	attttctcctgcatgataatcatttaacgcaccagcacggaccaTtaactcgtgcccccaaccgtggtgtagagcataaattccgcaccg
ycjG	gtttccgcccatctcctccgacgaagccagcgaaaaatatctctttgcgatggcaaacttgctgcgctggcatcTtaaagatgcaattcg
ycjZ	aatacgttaagagaagaattaaattaatgtatcagcaagtagtgTtaaacagcacctttatacttcagcctatctataaataatgagaat
intR	atgaacgacgaacagatagccatgttgaatgcgcggttatcgtaAttgcaaagtttgcccccaatttgccccatttagtaccagagaact
sieB	accgaaactggtgcgcgccgatggttggagaagcacacagtaagTtaacgattaaaacgtctactcctgctgttccagaataacttcata
b1354	ggctttacgcagcaacgactgggatctctggcaggcagaagtcgTtatacgtagcaacaagatgtgagattcgcaaaatgcaaaaaatcg
ydaY	ttcccccctttctcccccgaactccgataaccaccgctgggcagTtatggcttttttatcgtatcctgcttctgctgctctttaccctgg
b1367	gatttaattaaagacaccatcacatctctgtaacagagtgtacgtaattaacaaTtacacacactgctcctgaaaatactggtcatccag
tfaR	taaatggaaagatacatctaattatagaatttatatgttttaccTtacggcagtgctggccattcaatatcctgtgcagttgacgtatca
paaG	tgccgctcccaatcactgccacagtttgcacatttatcatcatgTtatttccccgtgaactgcggtgagcgtttagccaggaacgcactg
paaX	cggatggacaaaactctcttctggcacaaccggagtcagaccgtTtatctgataaattggcataacgcctcctgttcaatattcaagccg
b1402	cgggcttgtaatgggttaagtgataacagatgtctggaaatataAgggcaaatccagggttcttgtcccatgatgttcaaaactgtcaat
ydcL	ggatggggttttacggcgcaccggataaaaagcgccatctaacgatggcgcgtctggaaTtactttttgttaacgtcaaacatggtggca
rhsE	caacaaataaacaaagggtaattaaaaaaatgacaagtttgcctTtaataatttgaagcatctgaactcccttgctttgcttttattgga
yddJ	gaccttctggacagatcgttttcctccagttcatggcctttttaAtgaataaatcatcactaattctataagtgtctggtcttgttgata
ddpF	gcaatcattagcaataagggaggacggacgtgagctccggtgctggcgggcgctgtaAagatgctaacaacgcatcaggcattcacgcgc
yddV	agacgaggtagaaaccgtgttgaactctggaaagccagtctttaAatgcgccaggatgcagaggtaatcatgaagctaaccgatgcggat
ydeV	gaataactatactcaaaaactaacagccacggtcatcatgatgtggctgtcaatgaaaTtataacccaggcgctttccataacgacgtcg
ydeA	gccgcgttaatttggtcaatcattatatttcgccgctggccagtgacactcgaagaacagacgcaataAttgaaaggcccattcgggcct
marA	ggcgaatcgcgctttttacatccattaaatcattacaacagctaAttgaaaacgtgacaacgtcactgaggcaatcatgaaaccactttc
marB	atgggtactggcagtgataagtcggatgcgctcggcgtgccctattataatcaacacgctatgtaAtttgttctggccccgacatctcgg
tfaQ	taaatggaaagatacatctaattatagaatttatatgttttaccTtacggcagtgctggccattcaatatcctgtgcagttgacgtatca
ydfP	aaattttacattccgcgatgtaaatgttccgatttaatattaccTtacatttgatgctttttatctcttaaagattcatagatctgttga
rzpQ	gcagcggcattaagcattgccagaatgattacatacccgcgttaAtagctaatcaacaaagctaaggttagtaattaaggagttctccac
b1578	cgggcttgtaatgggttaagtgataacagatgtctggaaatataAgggcaaatccacaggtgaactacgctcctctgtttgttacgcaat
ynfA	gctgacacttcctcttatcttattgataaaatggatttatgttcTtacgtgcgcccccagcccgcaacaatgatcaacatgccgcaaagc
speG	cacaaaacaccgggtcagactctcctgaagccgaccgcacaataAcattaataataatcgatcgtatttttgatggtgtaaacccgttcg
dmsD	atcacaactgttaattcctgtcgcggttaaaccgctgtttcgataAgatcaccgtaatattgccggatggtgacgattacgcgcaatccg
ydhM	gcgctggcccatgtaaaaaacattattgcgacgcctgccgtttaAcaggcattttttatcaccagacgaccgggagcctttatgtcatct
lhr	aacgccgatgtttacgctgctgcgtgaggcgggattttcaagttcgccacaagggctggattggggataAagaaaggactgacggatgcc
ynhG	aatggcgcacattgtgcgccattttttttgtctgccgtttaccgTtactgcgtcacgcgtaacatattcccttgctctggttcaccattc
sufA	tttgacatcgtcagttgcttcagtattacgagacatagtaccgcTtataccccaaagctttcgccacagccacattcattctgggcttta
ydiA	accaagatcctcgatatcatgggccttagtcgccgaatgtactaAagaactagtgcattagcttatttttttgttatcatgctaaccacc
ydiE	catgacgggcaagaatatctgctccgtaaaactcaggctggcaagctgctgttgaccaagtaAcctttaactcgagcagctgacttccag
nlpC	ctactgtattcaggagtaaatggacggcgatgtatcatcgccgtccatttttcgacataTtagattcgtctcgcctgccagaaatttttc
btuC	tcagtaaaaatcttagcttttaatcatagaccgtctttttgcggTtaacgtcctgcttttaacaataaccagataaacaccggcgcacct
arpB_1	catagagaaaaaaactatacacccaacagtaaatctcaatggtaAtgcatgttttttgcaatctccttctgacgctattttttgtcgcca
ydjX	gcttcgcgccgcagcccacttactcacccaaaaaatgaaggataAaacgatgttgcaacattattcagtgtcatggaaaaaaggactggc
nudG	tgctgacattccattattagaggcgtttatggctttacgcgccgccagaccagcggattaAtgctaagggttttgtcatcacgctggcat
b1788	gaaaaccgcggattatttgcgcattgcgcaaccagaactggtcaatttccgccgcactgcgtaaTtagccggtccgttcgataagaagaa
yeaL	ggcgtaccggttgggccgcttattgccgcgggtctggtttcgctgattgtggggaaacagtaAttaatctcgcaatatatcggcctggcg
yeaX	aaagtatgttgatctgttgttcgcgtgcgaagggtaaacgcctggtgttggatttgtaAtttgccgaagccggatgtggcgctgagcgcg
yobB	cgttcatcacagggttggcaaggcgatatcattccattacgctaAgctttttcggcctggagcatgccatgttgcgcattatcgatacag
exoX	ccggagctgcgtttaacactgaaacattatctggaaaatacttaAtccgcaggcgtagcgggtaatgttccctgcgccagcgcgaccaga
yecN	aatctttggtatatgccctgggagttggttttctccctgcgttaAcgcacaatacgccactttctttttcccggatttttacgttatgtc
otsA	aggtcgatgtgctgttagttccacttacgggagattaaccgctcTtacgcaagctttggaaaggtagcaactttatcgcgctgctggctt
dcyD	atcaataaccagttgtatactttcttgcatgagcgtttccggagTtaaacgtggggatgataggcgaacagcgcaggcgcaccgccggta
yedM	cgtaaagttgtctagaaactctgcaatattagtcgatataaactTtaatttatgccgaatgggtgggttaccagttccctgattttttct
fliE	cccacgcggtgagatcggatgtaattaacaacaggttacaaaacTtacacctgcatgctcatcacttcctgatacgccgccaccagctta
fliN	gatatcattactccgtctgagcgaatgcgccgcctgagccgttaAtgatgaataaccacgctactgtgcaatcttccgcgccggtttctg
fliP	tggcaattgctggtcggttcgctggcgcagagcttttacagctaAagaggcaaaatgacacctgaatcggtcatgatgatggggactgaa
fliQ	accgtggatgctcaatctgttgctggattacgtccgcaccttgttcactaacctgccgtatatcatcgggtaAccgtactatgttgcagg
yedS_1	gctaatggtgttgcaacctaccgtaacaatggcttctttggttaAgtcgatggcttgaactttgctttgcaatatcagggtaataatgaa
cbl	ggagccaaattcctgaaaagcccgcttttatagcgggatttttgTtatatctgataatcaatttcctcttcactgctttccatcacctgc
b1996	ttggcaggccgtaaacaaatccgcattcgtggctggatttgcccTtatatttccagacatctgttatcacttaacccattacaagcccgc
hisL	gacacgcgttcaatttaaacaccaccatcatcaccatcatcctgactaAtctttcaggcgatgtgtgctggaagacattcagatcttcca
wbbJ	ggtaaatggaccgccagtggtaaaattgaccgcagaaacaacgaTtatgctttttcccataatttggtctcatgattgtatttctttatg
wcaM	ttgttcctaagtatgactccatttttccaggaatggtcgcaaatTtactccctcagttccggcaatctaaagttaatcttctccacatta
wcaL	ggaacgtgcgtcgggagagttttttaaatggcatgcgttctcctTtataaagcctgcagcaagctggcgagttctcgattgatcacctgc
wcaC	ttttgacgttaaccagcagataaatcagcggcagcaacaggtagTtacagattctgatagaagttgacatactcctccagcatctgttgt
asmA	ctttacgcgtcttatcaggcctacaggactggtcacctggtaacTtacatcttctccagcaacttcttcacatctttgccattacgggaa
baeR	ccgcgccgtttatggcgtcggttaccgctgggaagccgacgcctgccgcatcgtttaAttttagcgacattattttgttagccggagatg
gatR_1	tgccggatgcggtgtaaacaccttatccggcatacagaacaataTtacaccgtaattaattttacccgcgtcttctgcaatgccagttta
tra5_4	ggcggcctcagtccggaacaatttgaaaacaagaacctcgcttaAgcctgtgtccatattacgtgggtaggatcagtcatcccttcgtgg
yegV	gcgccaacgcgcgaggaactactcctcgcacacaaaaacgtataAatcgctgcgacagtggctaatgctgtactcaataggccgttgctg
yegW	gcgtcgtgggttgtcgggcatcggggcggtgattgtgcgccaacgcgcgaggaaTtactcctcgcacacaaaaacgtatagatcgctgcg
yehQ	aacggctggcgctatcaggaacagagtgctattggtcaggcataAttgctggcgaatgacctcaccgcggtgggtttttatcggctggca
yohC	cgtcaaaggagaatcgtgaggaaatgctgcattgctgacatttacgccagcaatgcaacgtcaaagaactttTtagaacaaacgataacc
yohF	cgaccaaaatattacccaatgaaatatccacgcacctcactgcgTtattctgggttgaactgtggattcgccaacataaagccgccatcc
sanA	acacccgaacagttacttgaattacaaaagaaacaaggaaagtaAttatggatgtacagcagttttttgtcgttgccgtttttttcctta
yejA	tggtatgacgtcaataaagcggccaaactgccgtccgccagcaaacagggagagtaAatgggcgcttacctgattcgccgtctgttgctg
yejE	ggtgaagccgtccgcgacgcatttgatcctaataaggcggtgtaAcatgacgcaaactctgttagcgattgaaaatttgtcggtgggttt
b2191	gagccgattttttctcccgtaaatgccttgaatcagcctatttaAaccgtttcttcgccatttaaggcgttatccccagtttttagtgag
rcsD	aaatacatcagcgacattgacagttatgtcaagagcttgctgtaAcaaggtagcctattacatgaacaatatgaacgtaattattgccga
rcsC	ggcatttgcactgaatgccggatgcggcgtaaacgccttatccgtcTtacgaatcccgcgatttcctgaccctctcggcatataacgtca
yfaT	ggaagcgaatcatcagcattagcaagccctgttcccacaagagacagggacaagcacgctgTtatcgcgccagaaaatttaaacgataaa
menF	aaaaatagattattgatatgaatcggtaatgatgcgactcattaTtattccatttgtaataaagtacgcagccctgccgctttgttgtcg
yfcO	tacgggtaatggcaggggcgaatgcccctgcctggtgtatctaagggTtacaactcattcagtatgtactggaaccggcaagtagaatcg
yfcU	tagctaacggtactgttgtcgccccacggcatactgagcgaaatTtacatgcccttatccgcccggttgtcatactcgtagcggtagcca
tfaS	ccagcaccgcgccggatgtcatctggcctgaactgccggaggagtaAgccattcaatatctggcgcactggaagtatcgaccagctccag
ypdI	ccttttccgacaaaggcgaattatcttattcatcctgtgcgataAcgtctttcacatggcaggtgaacaatcatgtctgatgctgatgtg
yfdY	tgatgctgatgtgaacacctgcccaaatgagccatcctgacccaTtaccgcctgccataccccaccataaagcgaatcatcaagccacaa
yfeO	atggtcaatcgtccgaagcaacagccaccccacgataacgtttaAcaaaaaatgctctcctttatgatttaagagttatggcgatgatac
mntH	ttacgccgcatccgccaatagtgccagatgcgacgctcattcaaTtacaatcccagcgccgtccccaccaacaaccagatattcagcgcc
xapR	ttcacttagcagactactatttccggcaattcctgtctcctcacTtactgtgtcaatgcagccaacagcttaaccatcgcgggcgtcacc
yfeR	gcgataatctactccatcaaatttaacttctgattgattactgccggggctcccggcagtatgaattcactTtatatctgatacaacgga
yffB	ggtttcagtgattccagttatcagcaatttttccatgaggtgtaAtctatgtcgtgcccggttattgagctgacacaacagcttattcgc
hda	agttcggataaggcgttcgcgccgcatccgacaataaacaccttatTtacaacttcagaatttctttcacaaacggaatggtcagcttac
yfgG	gctcagcaatccacactctccgtcgaatcaccggtacaacgttaAcggttaccttctccactttcacagaacataacggcacttcgctgt
pbpC	tttaaaataaaatgagttttagcaacaatcagggacaaaacagaTtattgcatgacaaatttcactgtcgcgatttgccccacgtcatcc
yphA	gtcagtatcgctggcgcgttcttgctattggcaattaccgggccgggggcaatttctctcgatcggcgttaAgaaagatgccggatgcgg
yfhB	aactccggttataaaagcgcggcgcattatacacggacgctatgctttactTtattccagttgctggagttcaccgcgcggggttactcg
kgtP	gatgtcgccggtgcaagcaccggctataccgtctggcaactgacccgtcaTtaaagacgcatccccttccctttgcgatgtagcatcaaa
yfiA	cgcaacatcggtgaaagacgccaacttcgtcgaagaagttgaagaagagtaAtcctttatattgagtgtatcgccaacgcgccttcgggc
yfjQ	ccgtgcgctgtgggtgatggcagaaacactgctcacgcaactgcagtaAacgtttcatgttgccacgttgttaatatcggacaccacctg
yfjR	gccttaccccattttcgctttatccagcattcactgcttacgtttgttccggccgacagcccaccggaataAcgcaggcgttgttatcaa
ypjC	aaaccaacatgaaaatcactttttcttatattatcgaaaaggttTtattcatttcttttagcgcattcaaaaaactgatcggcattattt
ygaQ	cgtagcattacagcgccagacaggataggagaaagaaaaacataAgtttatcaacgagatacaatgattgaaagaggtgataacagcggt
ygaR	gcgaagatcagtaaagatatagaaggtggtatccctggctattaAcaaggtcaggttttgattccattcattaaagatccagtaacaaaa
yqaC	attaaaaattatgatgggtccacgcgtgtcggcggtgaggcgtaActtaataaaggttgctctacctatcagcagctctacaatgaattc
gabT	tcaccattgaagacgctcagatccgtcagggtctggagatcatcagccagtgttttgatgaggcgaagcagtaAcgccgctcctatgccg
ygaU	tgacgccaattcccattatccagcaggcgatggctggcaattaaTtactcttccggaatacgcaacacttgccccggataaattttatcc
ygaM	gtaggtatttttatcggcgcactgttaagcatgcgcaaatcgtaAtgcaaaaatgataataaatacgcgtctttgaccccgaagcctgtc
luxS	tttgaactggcttttttcaattaattgtgaagatagtttactgaTtagatgtgcagttcctgcaacttctctttcggcagtgccagttct
mltB	aattttacgaggaggattcagaaaaaagctgattagccagagggaagctcacgcccccctcttgtaaatagTtactgtactcgcgccagc
srlE	actgtactgatcgcctggtttgtctccggttttatctatcaataAaggctgaaacatgaccgttatttatcagaccaccatcacccgtat
norW	atcggatgaaagaggcatttggattgttgaaaacattgccgatgtaAgtgggctactgtgcctaaaatgtcggatgcgacgctggcgcgt
ascB	atcattctggtggtataaaaaagtgattgccagtaatggggaagatttagagtaAgtaacagtgccggatgcggcgtgaacgccttatcc
hycI	tcaccccatcaagaacatccctgtcctgattccttaatgaaaaaTtactcttcttccaccgctaactgcgcgaagccgccatttccttcc
hypB	aagggatggaccagtggctgaactggctggagacacagcgatgtgcataAgcgttcccggccagatccgcaccattgacggcaaccaggc
ygbA	tgatttaactgcaaattgccggacagatctgcctgtccggcataTtattcatgaggttttttcggacgatatttttccggcagttctggc
pphB	gctaaccagatttatattgataccggatcgccgaacagcgggcggctgtcattttataaaataaagtaAtctcatgcttcttctgtgaag
ygcN	tggcatctggcgggcgatgttatcaggagtctgcgatgtctgtaAcccgtaatctctggcgcgttgctgatgcgccgcacattgttccgg
mazF	gtcaggtggaaacctgtgaccagaatagaagtgagttagtaacaTtacccaatcagtacgttaattttggctttaatgagttgtaattcc
relA	acagtatatatcaatctacattgtagatacgagcaaatttcggcTtaactcccgtgcaaccgacgcgcgtcgataacatccggcacctgg
rumA	cctctcctttagggaccagacctgccgaaatcggcaaatcgcaaTtatttaacgcgcgagaaaagtaccatcgattccagatgtcccgtg
ppdC	tccagacgattggaatggtagacccttaacatagcggctcctgaTtactgacgattcgggcaatgcaggcgggtcatctcgccttctctg
ptsP	ggctggttgccggataccgttaaaagatatgtatatgatccgcgTtataaccctccgcgaatcagcccgcccatgccgcgacgctccata
mutH	aatttcaccagtgcactactggcccgtcattttctgatccagtaAccatcgctttgacctgccgctttccgggcatataattaccgcttc
ygeA	aggcgtttagtgggcatttacaagcggggttaccgaaactggtcacttctcttgacgctattttgtcgtcagTtacgacagcataaaagc
kduI	tgcacttaaaatcataacaataccttattcgtttatgcccacaaTtagcgcaaatctttaacggccacatggtccatatcatcaaagacc
yqeF	gattaatgacggcagatatttatcggtaaggaggaaatgcagagTtattcgtcacgttcaatggtcaatgccacaccctggcccccgccg
ygeI	tcagaagataatcctatctcaccttactataaaattgagtggtaAacgattgaccaaataaatcataacgagatacttttataatagtat
pbl	tatgccccaaaatatatattgtatataccaggcttaatgaactaAacaatcgtaaggcttcagcaaaatgagcctaaagcctcttttttt
ygeM	ttacaattagattatattcaaatcattaaacttgagccagggagTtataagtcctcagggcttgccaaaacagaattattcatatccaaa
b2860	acagatcaatggaagtaaattccaattgtttattggatttgcccTtatatttccagacatctgttatcacttaacccattacaagcccgc
ygeP	cttatttaagtgatattggttgtctggagattcagggggccagtTtaaacttgctcttttcttctggtgtttatctttgaaagatttgta
yqeC	tgtgaaaatattcataccaacctcaatggatatcctttcagtaacccggaatacccgggccgTtaattcacaaatctgcgcgcgattgca
ygfJ	ccggacgactttattacagcgaaggaaaggtatactgaaatttaAaaaacgtagttaaacgattgcgttcaaatatttaatccttccggc
recJ	gggattgtacccaatccacgctcttttttatagagaagatgacgTtaaattggccagatattgtcgatgataatttgcaggctgcggttg
argO	ctctggaggcaagcttagcgcctctgttttatttttccatcagatagcgcTtaactgaacaaggcttgtgcatgagcaataccgtctctc
yggU	aatccgcaacaaatcccgccagaaatcgcggcgttaattaattaAgtatcctatgcaaaaagttgtcctcgcaaccggcaatgtcggtaa
mutY	gtggagcgtttgttacagcagttacgcactggcgcgccggtttaAcgcgtgagtcgataaagaggatgatttatgagcagaacgattttt
glcC	gccaccatttgattcgctcggcggtgccgctggagatgaacctgagttaActggtattaaatctgcttttcatacaatcggtaacgcttg
yghQ	actgagtcagccgagaagaatttccccgcttattcgcaccttccTtaaatcaggtcatacgcttcgagatacttaacgccaaacaccagc
yghT	tggttgatgcagaaaaagcgattacggattttatgaccgcgcgtggttatcactaAtcaaaaatggaaatgcccgatcgccaggaccggg
ygiZ	ttctctgtctatgagagccgttaaaacgactctcatagattttaTtaatagcaaaatataaaccgtccccaaaaaagccaccaaccacaa
yqiB	agggttaacaggctttccaaatggtgtccttaggtttcacgacgTtaataaaccggaatcgccatcgctccatgtgctaaacagtatcgc
b3045	cgggcttgtaatgggttaagtgataacagatgtctggaaatataAgggcaaatccagttatcatcattggttgtgcgtcagcttatgccg
yqiI	ttgttgagggaccgtttagtaaagacgtaatcctgaaaatcacctataactaAtatctaatacaaacactaaaacgggccatcaggcccg
ygiP	attcaaaagaaagcgcgaaaaggatcccgagtgatttctggtggatTtacatgacctgatagccttcatcgggcttgcccagccgttgct
yhaK	gccgattccccactgcgcgctttgctgatagatttgcctgtctaAttgtttttacagggagatgatgatgagtaaaaaattggccaaaaa
tdcA	aagacagacaggtggattatttatgtttaaataaaaacaaataaTtaaccaacttctattaattgccttcgtctacacccattataagat
yhaC	agagaggactatacgtatgattacgaccttttaaatgcaatataAacttaataacttcttacaaagtctattattaataccgtagatatt
ecfH	gccgggtgagcggcgtgaagcgggtaactacggcgtttacgtttattaaataAcagccccttgtaatgcctgatgcgacgcttgccgcgt
yhbW	tcgtttgagctggcgatggatgttaaggaagagttgttgggataAtgtgtcttaacgcgggaagccttatccgagctggcaacgctgtcc
nlpI	cgttaaggtgatggcaatcaaaaaagattacgggctgatgtgtacgtcagTtattgctggtccgattctgccaggtcatcttggtcctgg
dacB	cgccgtattccgttagtgcgttttgaaagccgtttgtataaagatatttatcagaacaattaAtcaaaaagaaaccccggcacatggccg
ptsN	ccagagcgatgaagagctgtatcaaatcattacggataccgaaggtactccggatgaagcgtaAttattcggtaatgtctcttttagacg
yhcC	tacgttataaattgtgtgagaaatgcggaattcccctcaacgacTtactccgttggaggtagccacggacgtcccagcgccgatccctgt
yhcE	gagccgattttttctcccgtaaatgccttgaatcagcctatttaAaccgtttcttcgccatttaaggcgttatccccagtttttagtgag
yhcO	ggctgaactgtacaaataaaccctcatcgtcttgtccgacgatattgcccccggttcgggggcttttttttgcgTtaatgacgaacatta
mreC	agcaacagcgcaatgaggaaagagagccagattacccagcgtccctggctacgatagctcgccaTtattgccctcccggcgcacgcgcag
yhdN	ccgccatttttgccagctcaccaatgcgatacatacatactccaTtagttatcgttgattttgtccaacaacttgtcagcataatcgccg
kefB	tttgcgcccgcaataaaacgttttcggattgccatctttaccctTtactcaaattcatcccagccgtccagctggcgtcgttcttgttgc
frlD	atgacattaccgcaggcgatagcgcagggaacggcgtgcgcggcgaaaaccattcagtaccacggtgcctggtaAgtataacgttggcgt
bioH	ctttaccgggctgtcagaagaagagttggctgcggcgagtcagtaaagttctgtctcgccatttcaaaagccacTtacaccctctgcttc
gntX	ggtgcggcggctgtccaggtctggtgcctttgtcgaaccttgtaAagcctcgatgatgggcgtattataaccaactaaaatagtcaacta
malQ	ccggataagacgcgtcaagcatcgcatccggcatcaaccgcactTtacttcttcttcgctgcagctctgcgccgtctgtccaaatccttc
glgA	gatgaatatgtaaacggagcattcatataggcgtttcctgaaaaTtatttcaagcgatagtaaagctcacggtacgacttcgccgcgacc
yrhA	tttacttatgacattaaaggtgatgctgccaacttactgatttaAtgtatgatggtgtttttgaggtgctccagtggcttctgtttctat
ugpQ	ctgccggagaggagaaacggcgacatgctgaatcagcccagcacgccgcagcctgacattccgttgaaaaTtattgggccgtaaagttcg
gadE	cgtatgagcgacatcgtcaccctgggtatcacatcttatttttaAtcaggacataagcaactgaaattgatggctggcatgacgagggat
gadX	tcccggtcccctatgccgggttttttttatgtctgagtaaaactTtataatcttattccttccgcagaacggtcagtgccgtaaaaattc
yhjK	cacaaaccagcactttttaaagttttgtaatcagtttggggtagTtacttttcttccaggtaactctcttcgaagatttcaatagggagt
yhjR	tccccgcaccccctgctatcccagtacggccattcaccaatcccTtacttttgttgcgcaaactctgccagcaacggccagcgttttaat
yiaG	cgtttgattcaagccaacccggcattaagtaagcagttgatggaataAacttttatccactttattgctgtttacggtcctgatgacagg
xylR	tatgacacgacgccaaaagagtatcgcgatgtaaatagcgaggtcatgttgtaAcgatgatgagaattgtcggcgtcacatcaggtaacg
sgbU	ggagattattcaggcgcggcgttggattgaagcgcgtatgcaggaggctggatttatatgttaAagcaactgaaagccgacgtgctggcg
rhsA	tggaattgtcgtcactccagacagtcaaacgataaaaaaagataAcccttgtggaggttcctgcaatgtcaaatacataccagaaaagaa
yibA	tgacaatgaaattataacttccgctattgataagctgaagcgttcataAcgtgagttgcctatgcacagtgggggattcccgccggcacg
lctD	taaagagttgcctgcggcactggctcccatggcgaaagggaatgcggcataAtcgtttgcgccccctcaccctaaccctctccctcaggg
yibK	ggtgtatgaagcctggcggcagttggggtatccgggagcggtattgagagattaAttactgtaggccggatagatgattacatcgcatcc
yibD	cacgctgatcgtttacttccagcatcagtggcaaggctggggcaaacagcccgaagcggcgaagtttaacgTtagcgcaaattaaaggcg
htrL	tatctcagttggtatcaaaacgctacccactaatggagggaaacTtattttcttgaaaggaaaattctcagcgcctgcatttttgcccct
coaD	atcagggcgatgtcacccatttcctgccggagaatgtccatcaggcgctgatggcgaagttagcgtaAcgtttatgccggatggtatgcc
rph	cagtcgccttaaaaatcagtttgccagcgccgccttctgcgtcgTtacaatggattcgattcccctcgggccagagccaacaagatgagt
dinD	atcaagcagttggaaaacagtgtaaaaattacagagaagaaataAcagaaactaaaaactctttttgttgattgagacacccgatgcgta
ligB	cttactggcgctacgccttaagctgggattaccggtcttttactacagccacgaaggacaTtaaggttcaaaacctgtgatctgctgggc
setC	ttgggtattgcgatgatttgcctgctgtttattaaagatatttaActcaccagtctgggctaagaaaaatcggcgtggcgcaaacagagc
yicO	ctgcgtaatcagaactcatgatatctggaaaccctcgccagttaTtaatccaccagaataatcttcagtgcaaacagagctgcgaccacc
ivbL	ggtttgcgccggcggggttttggaatcgtgtgttgttccagtccTtacggcgcattgccgacgaccaccaccacacgcacgacgaccact
yidH	gctccggctgcagtcctgggtcggcaatgcgtctggctttgcggTtatccggcatacaacaccagtcccataacgatcaccgccacgacc
glvC	tccgcgtggttgctgaacatcgggatccagttttgcggtaaaacTtagtcaatcagacctccgcccatgttgcccaccacaccaaagaga
yidS	gattatgcgcagtggtgtggcacatattccacagttgaaggattaAccaacgcgcttcacatcgcccaccagcaggatataagagagcgc
yieH	ttacctgaactgtggaaagcgcgtggttgggatattacggcataAttcttcacactcccttcacttaccccgcttaaattggcgctcaaa
yieJ	tgtctccactgcggcaagctgagactgtggggtgatttttcgtaAttatttaaataatgagaacaggccggagcgtaattcacacatccg
atpE	tagttaacgttctgatattgctctttaaataaaagcaacgcttaTtacgcgacagcgaacatcacgtacagacccagacctacagcgatc
